####B###
#    ###
# ######
#     ##
#A######
